  1111111
  100111
11100111
1100N1
111111